................................................................................................................................................
................................................................................................................................................
................................................................................................................................................
................................................................................................................................................
................................................................................................................................................
................................................................................................................................................
................................................................................................................................................
........C.........C..............Y..............................................................................................................
........11........11........1111111111..........................................................................................................
................................................................................................................................................
................................................................................................................................................
...........................................M....................................................................................................
P..................L.............................CCC............................................................................................
11.................1.......................11111111111111111111.................................................................................
................................................................................................................................................
................................................................................................................................................
............................................................................................................L....................CCCC.........O.
......................................................................1.........1111..........11.......111..1......11111111111111111111111111111
TTTTTTTTTTTTTTTTTTTTTTTTTTTTTTTTTTTTTTTTTTTTTTTTTTTTTTTTTTTTTTTTTTTTTTTTTTTTTTTTTTTTTTTTTTTTTTTTTTTTTTTTTTTTTTTTTTTTTTTTTTTTTTTTTTTTTTTTTTTTTTTT